#######################################
#.....................................#
#................#######..............#
#.....................................#
#.....................................#
#.....................................#
#.....................................#
#.....................................#
#.....................................#
#.......########......................#
#..............#......................#
#..........#####......................#
#..............#......................#
#..............#......................#
#........#######......................#
#.....................................#
#.....................................#
#.....................................#
#.....................................#
#.......#.............................#
#......##.............................#
#...####..............................#
#.....................................#
#.....................................#
#.....................................#
#.....................................#
#......................#..............#
#......................#..............#
#......................#..............#
#...................####..............#
#...................#.................#
#...................#.................#
#...................#.................#
#.....................................#
#.....................................#
#.....................................#
#.....................................#
#.....................................#
#######################################