#######################################
#.....................................#
#.....................................#
#.....................................#
#.....................................#
#.....................................#
#.....................................#
#.....................................#
#.....................................#
#..............#......................#
#..............#......................#
#..............#......................#
#..............#......................#
#..............#......................#
#..............#......................#
#.....................................#
#.....................................#
#.....................................#
#.....................................#
#.....................................#
#.....................................#
#.....................................#
#.....................................#
#.....................................#
#.....................................#
#.....................................#
#......................#..............#
#......................#..............#
#......................#..............#
#...................####..............#
#...................#.................#
#...................#.................#
#...................#.................#
#.....................................#
#.....................................#
#.....................................#
#.....................................#
#.....................................#
#######################################