#######################################
#.....................................#
#..#####..............................#
#.....................................#
#.............#######.................#
#.....................................#
#.....................................#
#.....................................#
#.....................................#
#...........####......................#
#..............#......................#
#..............#......................#
#...........####......................#
#...........###.......................#
#...........####......................#
#.....................................#
#.....................................#
#.....................................#
#.....................................#
#.....................................#
#.................#####...............#
#.....................................#
#.....................................#
#.....................................#
#.....................................#
#.....................................#
#......................#..............#
#......................#..............#
#......................#..............#
#...................####..............#
#...................#.................#
#...................#.................#
#...................#.................#
#...................#.................#
#...................#.................#
#...................#.................#
#.....................................#
#.....................................#
#######################################